3,3,3,3,3,3,3,3,3,3
3,4,4,4,4,4,4,4,4,3
3,4,0,0,0,0,0,0,4,3
3,4,0,0,0,0,0,0,4,3
3,4,0,0,0,0,0,0,4,3
3,4,0,0,0,0,0,0,4,3
3,4,0,0,0,0,0,0,4,3
3,4,0,0,0,0,0,0,4,3
3,4,4,4,4,4,4,4,4,3
3,3,3,3,3,3,3,3,3,3